####   ####
#  #####  #
# $#. .#$ #
#  ..@..  #
# $#. .#$ #
#  # # #  #
# $# # #$ #
#  # # #  #
# $# # #$ #
#    #    #
###########

