  #####
 #    @#
 #$ $#####
# .#   $  #
#*.. $    #
# *.*.  # #
#   ##$## #
 ### #    #
      ####