#############
#  #     #..#
# $#@ $ $#..##
# $ $ # $ .$.#
#     # $ ..##
#############
