########
##    ##
##. * ##
# . $  #
# #**# #
#  *+* #
## $$ ##
##    ##
########
