 ######################### 
 #  #  #  #  #  #  #  #  # 
 # $#$ # $#$ # $#$ # $#$ # 
 #  #  #  #  #  #  #  #  # 
 ## # ### # ### # ### # ## 
 #  #  #  #  #  #  #  #  # 
 #     #     #     #     # 
## ### # ### # ### # ### ##
#   #  #  #  #  #  #  #   #
#   #  #  #  @  #  #  #   #
##  # ### # ### # ### #  ##
 #  .  . . .   . . .  .  # 
 ######################### 
