########
# .... #
#  $@$ #
##### ####
 ###     #
 #     $ #
 #   ##$ #
 ######  #
      ####