#######
#. . .#
# $# ##
#  $$ #
#.  $@#
#######