  #######
### @ ####
#   #    #
# $#  $$ #
# $ $#$  #
###$...###
  # ....# 
  ####### 
