   #####
####   #
#@$  # #
# $$$  #
##.#.  #
#  ..# #
#  #.* #
# $.$ ##
###   #
  #####

