      ####
####### @#
#     $  #
#   $## $#
##$#...# #
 # $. .  #
 # #. .# ##
 #   # #$ #
 #$       #
 #  #######
 ####






