##########
#   @    #
# $$$$$$ #
#        #
#### #####
  #.  #   
  #.  #   
  #...#   
  #.  #   
##########
