##########
#####    #
##   @ $ #
##.##*#* #
#   * *  #
# *   # ##
####    ##
######  ##
##########
